{
  "width": 50,
  "height": 50,
  "spawn": {"x": 2.5, "y": 2.5},
  "rows": [
    "##################################################",
    "#................................................#",
    "#................................................#",
    "#................................................#",
    "#................................................#",
    "#.............................#..................#",
    "#.............................#..................#",
    "#.............................#..................#",
    "#.......~~~~~~~...............#..................#",
    "#.......~~~~~~~...............#..................#",
    "#.......~~~~~~~...............#..................#",
    "#.......~~~~~~~...............#..................#",
    "#.......~~~~~~~...............#..................#",
    "#.......~~~~~~~...............#..................#",
    "#.......~~~~~~~...............#..................#",
    "#.............................#..................#",
    "#.............................#..................#",
    "#.............................#..................#",
    "#.............................#..................#",
    "#.............................#..................#",
    "#.............................#..................#",
    "#.............................#..................#",
    "#.............................#..................#",
    "#................................................#",
    "#................................................#",
    "#.........##########################.............#",
    "#................................................#",
    "#................................................#",
    "#...................~~~~~~.......................#",
    "#...................~~~~~~.......................#",
    "#...................~~~~~~.......................#",
    "#...................~~~~~~.......................#",
    "#...................~~~~~~.......................#",
    "#...................~~~~~~.......................#",
    "#...^^^^^^^.........~~~~~~.......................#",
    "#...^^^^^^^........................^^^^^^^^......#",
    "#...^^^^^^^........................^^^^^^^^......#",
    "#...^^^^^^^........................^^^^^^^^......#",
    "#...^^^^^^^........................^^^^^^^^......#",
    "#...^^^^^^^........................^^^^^^^^......#",
    "#...^^^^^^^........................^^^^^^^^......#",
    "#..................................^^^^^^^^......#",
    "#..................................^^^^^^^^......#",
    "#..................................^^^^^^^^......#",
    "#................................................#",
    "#................................................#",
    "#................................................#",
    "#................................................#",
    "#................................................#",
    "##################################################"
  ],
  "npcs": [
    {"id": "npc-merchant-1", "name": "Rurik", "role": "merchant", "x": 5, "y": 5},
    {"id": "npc-quest-1", "name": "Elda", "role": "quest_giver", "x": 7, "y": 6}
  ],
  "mobs": [
    {"id": "mob-slime-1", "name": "Green Slime", "x": 16, "y": 16, "hp": 60, "damage": 8, "patrol_radius": 6},
    {"id": "mob-slime-2", "name": "Blue Slime", "x": 22, "y": 18, "hp": 70, "damage": 9, "patrol_radius": 7},
    {"id": "mob-wolf-1", "name": "Forest Wolf", "x": 38, "y": 37, "hp": 95, "damage": 12, "patrol_radius": 8}
  ]
}
